000000000
000000000
002222220
002020000
002020000
002020000
002000000
002000000